10.47.50.215,208.80.154.224,57591,https,tcp,579,303,276,311509,31568,279941,1555360272,72,1
10.47.50.215,208.80.154.240,57592,https,tcp,712,340,372,472832,22032,450800,1555360272,72,1
10.47.50.215,64.233.177.138,62929,https,udp,132,63,69,53843,39925,13918,1555360272,71,1
10.47.50.215,52.96.12.178,57626,https,tcp,590,302,288,101533,36512,65021,1555360288,51,1
10.47.50.215,52.96.12.178,57627,https,tcp,104,56,48,26308,10738,15570,1555360288,1,1
10.47.50.215,52.96.12.178,57628,https,tcp,102,55,47,26885,11030,15855,1555360288,1,1
10.47.50.215,52.96.12.178,57629,https,tcp,216,114,102,49363,21051,28312,1555360288,1,1
10.47.50.215,52.96.12.178,57630,https,tcp,100,54,46,25589,10201,15388,1555360288,1,1
10.47.50.215,208.80.154.224,57591,https,tcp,579,303,276,311509,31568,279941,1555360272,72,1
10.47.50.215,208.80.154.240,57592,https,tcp,712,340,372,472832,22032,450800,1555360272,72,1
10.47.50.215,64.233.177.138,62929,https,udp,132,63,69,53843,39925,13918,1555360272,71,1
10.47.50.215,52.96.12.178,57626,https,tcp,590,302,288,101533,36512,65021,1555360288,51,1
10.47.50.215,52.96.12.178,57627,https,tcp,104,56,48,26308,10738,15570,1555360288,1,1
10.47.50.215,52.96.12.178,57628,https,tcp,102,55,47,26885,11030,15855,1555360288,1,1
10.47.50.215,52.96.12.178,57629,https,tcp,216,114,102,49363,21051,28312,1555360288,1,1
10.47.50.215,52.96.12.178,57630,https,tcp,100,54,46,25589,10201,15388,1555360288,1,1
10.47.50.215,208.80.154.224,57591,https,tcp,579,303,276,311509,31568,279941,1555360272,72,1
10.47.50.215,208.80.154.240,57592,https,tcp,712,340,372,472832,22032,450800,1555360272,72,1
10.47.50.215,64.233.177.138,62929,https,udp,132,63,69,53843,39925,13918,1555360272,71,1
10.47.50.215,52.96.12.178,57626,https,tcp,590,302,288,101533,36512,65021,1555360288,51,1
10.47.50.215,52.96.12.178,57627,https,tcp,104,56,48,26308,10738,15570,1555360288,1,1
10.47.50.215,52.96.12.178,57628,https,tcp,102,55,47,26885,11030,15855,1555360288,1,1
10.47.50.215,52.96.12.178,57629,https,tcp,216,114,102,49363,21051,28312,1555360288,1,1
10.47.50.215,52.96.12.178,57630,https,tcp,100,54,46,25589,10201,15388,1555360288,1,1
10.47.50.215,208.80.154.224,57591,https,tcp,579,303,276,311509,31568,279941,1555360272,72,1
10.47.50.215,208.80.154.240,57592,https,tcp,712,340,372,472832,22032,450800,1555360272,72,1
10.47.50.215,64.233.177.138,62929,https,udp,132,63,69,53843,39925,13918,1555360272,71,1
10.47.50.215,52.96.12.178,57626,https,tcp,590,302,288,101533,36512,65021,1555360288,51,1
10.47.50.215,52.96.12.178,57627,https,tcp,104,56,48,26308,10738,15570,1555360288,1,1
10.47.50.215,52.96.12.178,57628,https,tcp,102,55,47,26885,11030,15855,1555360288,1,1
10.47.50.215,52.96.12.178,57629,https,tcp,216,114,102,49363,21051,28312,1555360288,1,1
10.47.50.215,52.96.12.178,57630,https,tcp,100,54,46,25589,10201,15388,1555360288,1,1
10.47.50.215,40.136.10.141,64031,https,udp,402,103,299,413870,8110,405760,1555360353,0,2
10.47.50.215,172.217.10.206,50663,https,udp,119,53,66,61413,27061,34352,1555360355,23,2
10.47.50.215,40.136.10.140,62211,https,udp,1036,274,762,1050917,20979,1029938,1555360355,28,2
10.47.50.215,74.125.159.27,63597,https,udp,2409,379,2030,2806124,28157,2777967,1555360355,18,2
10.47.50.215,40.136.10.150,51054,https,udp,135,47,88,120813,4352,116461,1555360369,0,2
10.47.50.215,40.97.147.18,57641,https,tcp,1215,613,602,295503,41875,253628,1555360384,1,2
10.47.50.215,40.136.10.141,64031,https,udp,402,103,299,413870,8110,405760,1555360353,0,2
10.47.50.215,172.217.10.206,50663,https,udp,119,53,66,61413,27061,34352,1555360355,23,2
10.47.50.215,40.136.10.140,62211,https,udp,1036,274,762,1050917,20979,1029938,1555360355,28,2
10.47.50.215,74.125.159.27,63597,https,udp,2409,379,2030,2806124,28157,2777967,1555360355,18,2
10.47.50.215,40.136.10.150,51054,https,udp,135,47,88,120813,4352,116461,1555360369,0,2
10.47.50.215,40.97.147.18,57641,https,tcp,1215,613,602,295503,41875,253628,1555360384,1,2
10.47.50.215,40.136.10.141,64031,https,udp,402,103,299,413870,8110,405760,1555360353,0,2
10.47.50.215,172.217.10.206,50663,https,udp,119,53,66,61413,27061,34352,1555360355,23,2
10.47.50.215,40.136.10.140,62211,https,udp,1036,274,762,1050917,20979,1029938,1555360355,28,2
10.47.50.215,74.125.159.27,63597,https,udp,2409,379,2030,2806124,28157,2777967,1555360355,18,2
10.47.50.215,40.136.10.150,51054,https,udp,135,47,88,120813,4352,116461,1555360369,0,2
10.47.50.215,40.97.147.18,57641,https,tcp,1215,613,602,295503,41875,253628,1555360384,1,2
10.47.50.215,40.136.10.141,64031,https,udp,402,103,299,413870,8110,405760,1555360353,0,2
10.47.50.215,172.217.10.206,50663,https,udp,119,53,66,61413,27061,34352,1555360355,23,2
10.47.50.215,40.136.10.140,62211,https,udp,1036,274,762,1050917,20979,1029938,1555360355,28,2
10.47.50.215,74.125.159.27,63597,https,udp,2409,379,2030,2806124,28157,2777967,1555360355,18,2
10.47.50.215,40.136.10.150,51054,https,udp,135,47,88,120813,4352,116461,1555360369,0,2
10.47.50.215,40.97.147.18,57641,https,tcp,1215,613,602,295503,41875,253628,1555360384,1,2
10.47.50.215,40.136.10.141,64031,https,udp,402,103,299,413870,8110,405760,1555360353,0,2
10.47.50.215,172.217.10.206,50663,https,udp,119,53,66,61413,27061,34352,1555360355,23,2
10.47.50.215,40.136.10.140,62211,https,udp,1036,274,762,1050917,20979,1029938,1555360355,28,2
10.47.50.215,74.125.159.27,63597,https,udp,2409,379,2030,2806124,28157,2777967,1555360355,18,2
10.47.50.215,40.136.10.150,51054,https,udp,135,47,88,120813,4352,116461,1555360369,0,2
10.47.50.215,40.97.147.18,57641,https,tcp,1215,613,602,295503,41875,253628,1555360384,1,2
10.47.50.215,10.47.69.131,50004,5286,udp,5669,4248,1421,2670494,2502275,168219,1555360403,25,3
10.47.50.215,10.47.69.131,50004,5286,udp,5669,4248,1421,2670494,2502275,168219,1555360403,25,3
10.47.50.215,10.47.69.131,50004,5286,udp,5669,4248,1421,2670494,2502275,168219,1555360403,25,3
10.47.50.215,10.47.69.131,50004,5286,udp,5669,4248,1421,2670494,2502275,168219,1555360403,25,3
10.47.50.215,10.47.69.131,50004,5286,udp,5669,4248,1421,2670494,2502275,168219,1555360403,25,3
10.47.50.215,10.47.69.131,50004,5286,udp,5669,4248,1421,2670494,2502275,168219,1555360403,25,3
10.47.50.215,10.47.69.131,50004,5286,udp,5669,4248,1421,2670494,2502275,168219,1555360403,25,3
10.47.50.215,10.47.69.131,50004,5286,udp,5669,4248,1421,2670494,2502275,168219,1555360403,25,3
10.47.50.215,10.47.69.131,50004,5286,udp,5669,4248,1421,2670494,2502275,168219,1555360403,25,3
10.47.50.215,10.47.69.131,50004,5286,udp,5669,4248,1421,2670494,2502275,168219,1555360403,25,3
10.47.50.215,10.47.69.131,50004,5286,udp,5669,4248,1421,2670494,2502275,168219,1555360403,25,3
10.47.50.215,10.47.69.131,50004,5286,udp,5669,4248,1421,2670494,2502275,168219,1555360403,25,3
10.47.50.215,10.47.69.131,50004,5286,udp,5669,4248,1421,2670494,2502275,168219,1555360403,25,3
10.47.50.215,10.47.69.131,50004,5286,udp,5669,4248,1421,2670494,2502275,168219,1555360403,25,3
10.47.50.215,10.47.69.131,50004,5286,udp,5669,4248,1421,2670494,2502275,168219,1555360403,25,3
10.47.50.215,10.47.69.131,50004,5286,udp,5669,4248,1421,2670494,2502275,168219,1555360403,25,3
10.47.50.215,10.47.69.131,50004,5286,udp,5669,4248,1421,2670494,2502275,168219,1555360403,25,3
10.47.50.215,10.47.69.131,50004,5286,udp,5669,4248,1421,2670494,2502275,168219,1555360403,25,3
10.47.50.215,10.47.69.131,50004,5286,udp,5669,4248,1421,2670494,2502275,168219,1555360403,25,3
10.47.50.215,10.47.69.131,50004,5286,udp,5669,4248,1421,2670494,2502275,168219,1555360403,25,3
10.47.50.215,10.47.69.131,50004,5286,udp,5669,4248,1421,2670494,2502275,168219,1555360403,25,3
10.47.50.215,10.47.69.131,50004,5286,udp,5669,4248,1421,2670494,2502275,168219,1555360403,25,3
10.47.50.215,10.47.69.131,50004,5286,udp,5669,4248,1421,2670494,2502275,168219,1555360403,25,3
10.47.50.215,10.47.69.131,50004,5286,udp,5669,4248,1421,2670494,2502275,168219,1555360403,25,3
10.47.50.215,10.47.69.131,50004,5286,udp,5669,4248,1421,2670494,2502275,168219,1555360403,25,3
80.249.99.148,10.47.50.215,http,57658,tcp,62834,50821,12013,76892044,76231500,660544,1555360447,39,4
10.47.50.215,80.249.99.148,57662,http,tcp,21041,5403,15638,23747532,293420,23454112,1555360459,27,4
80.249.99.148,10.47.50.215,http,57658,tcp,62834,50821,12013,76892044,76231500,660544,1555360447,39,4
10.47.50.215,80.249.99.148,57662,http,tcp,21041,5403,15638,23747532,293420,23454112,1555360459,27,4
80.249.99.148,10.47.50.215,http,57658,tcp,62834,50821,12013,76892044,76231500,660544,1555360447,39,4
10.47.50.215,80.249.99.148,57662,http,tcp,21041,5403,15638,23747532,293420,23454112,1555360459,27,4
80.249.99.148,10.47.50.215,http,57658,tcp,62834,50821,12013,76892044,76231500,660544,1555360447,39,4
10.47.50.215,80.249.99.148,57662,http,tcp,21041,5403,15638,23747532,293420,23454112,1555360459,27,4
80.249.99.148,10.47.50.215,http,57658,tcp,62834,50821,12013,76892044,76231500,660544,1555360447,39,4
10.47.50.215,80.249.99.148,57662,http,tcp,21041,5403,15638,23747532,293420,23454112,1555360459,27,4
80.249.99.148,10.47.50.215,http,57658,tcp,62834,50821,12013,76892044,76231500,660544,1555360447,39,4
10.47.50.215,80.249.99.148,57662,http,tcp,21041,5403,15638,23747532,293420,23454112,1555360459,27,4
80.249.99.148,10.47.50.215,http,57658,tcp,62834,50821,12013,76892044,76231500,660544,1555360447,39,4
10.47.50.215,80.249.99.148,57662,http,tcp,21041,5403,15638,23747532,293420,23454112,1555360459,27,4
80.249.99.148,10.47.50.215,http,57658,tcp,62834,50821,12013,76892044,76231500,660544,1555360447,39,4
10.47.50.215,80.249.99.148,57662,http,tcp,21041,5403,15638,23747532,293420,23454112,1555360459,27,4
80.249.99.148,10.47.50.215,http,57658,tcp,62834,50821,12013,76892044,76231500,660544,1555360447,39,4
10.47.50.215,80.249.99.148,57662,http,tcp,21041,5403,15638,23747532,293420,23454112,1555360459,27,4
80.249.99.148,10.47.50.215,http,57658,tcp,62834,50821,12013,76892044,76231500,660544,1555360447,39,4
10.47.50.215,80.249.99.148,57662,http,tcp,21041,5403,15638,23747532,293420,23454112,1555360459,27,4
80.249.99.148,10.47.50.215,http,57658,tcp,62834,50821,12013,76892044,76231500,660544,1555360447,39,4
10.47.50.215,80.249.99.148,57662,http,tcp,21041,5403,15638,23747532,293420,23454112,1555360459,27,4
80.249.99.148,10.47.50.215,http,57658,tcp,62834,50821,12013,76892044,76231500,660544,1555360447,39,4
10.47.50.215,80.249.99.148,57662,http,tcp,21041,5403,15638,23747532,293420,23454112,1555360459,27,4
80.249.99.148,10.47.50.215,http,57658,tcp,62834,50821,12013,76892044,76231500,660544,1555360447,39,4
10.47.50.215,80.249.99.148,57662,http,tcp,21041,5403,15638,23747532,293420,23454112,1555360459,27,4
